Nucleotide	Sequence	Modified_mutations	Modified_read_depth	Modified_effective_depth	Modified_rate	Modified_off_target_mapped_depth	Modified_low_mapq_mapped_depth	Modified_mapped_depth	Untreated_mutations	Untreated_read_depth	Untreated_effective_depth	Untreated_rate	Untreated_off_target_mapped_depth	Untreated_low_mapq_mapped_depth	Untreated_mapped_depth	Denatured_mutations	Denatured_read_depth	Denatured_effective_depth	Denatured_rate	Denatured_off_target_mapped_depth	Denatured_low_mapq_mapped_depth	Denatured_mapped_depth	Reactivity_profile	Std_err	HQ_profile	HQ_stderr
1	G	0	0	0	nan	0	0	0	0	0	0	nan	0	0	0	0	0	0	nan	0	0	0	nan	nan	nan	nan
2	G	0	0	0	nan	0	0	0	0	0	0	nan	0	0	0	0	0	0	nan	0	0	0	nan	nan	nan	nan
3	C	0	0	0	nan	0	0	0	0	0	0	nan	0	0	0	0	0	0	nan	0	0	0	nan	nan	nan	nan
4	C	0	0	0	nan	0	0	0	0	0	0	nan	0	0	0	0	0	0	nan	0	0	0	nan	nan	nan	nan
5	C	0	0	0	nan	0	0	0	0	0	0	nan	0	0	0	0	0	0	nan	0	0	0	nan	nan	nan	nan
6	U	0	0	0	nan	0	0	0	0	0	0	nan	0	0	0	0	0	0	nan	0	0	0	nan	nan	nan	nan
7	U	0	0	0	nan	0	0	0	0	0	0	nan	0	0	0	0	0	0	nan	0	0	0	nan	nan	nan	nan
8	U	0	0	0	nan	0	0	0	0	0	0	nan	0	0	0	0	0	0	nan	0	0	0	nan	nan	nan	nan
9	A	0	0	0	nan	0	0	0	0	0	0	nan	0	0	0	0	0	0	nan	0	0	0	nan	nan	nan	nan
10	G	0	0	0	nan	0	0	0	0	0	0	nan	0	0	0	0	0	0	nan	0	0	0	nan	nan	nan	nan
11	C	0	0	0	nan	0	0	0	0	0	0	nan	0	0	0	0	0	0	nan	0	0	0	nan	nan	nan	nan
12	U	0	0	0	nan	0	0	0	0	0	0	nan	0	0	0	0	0	0	nan	0	0	0	nan	nan	nan	nan
13	C	0	0	0	nan	0	0	0	0	0	0	nan	0	0	0	0	0	0	nan	0	0	0	nan	nan	nan	nan
14	A	0	0	0	nan	0	0	0	0	0	0	nan	0	0	0	0	0	0	nan	0	0	0	nan	nan	nan	nan
15	G	0	0	0	nan	0	0	0	0	0	0	nan	0	0	0	0	0	0	nan	0	0	0	nan	nan	nan	nan
16	U	0	0	0	nan	0	0	0	0	0	0	nan	0	0	0	0	0	0	nan	0	0	0	nan	nan	nan	nan
17	G	0	0	0	nan	0	0	0	0	0	0	nan	0	0	0	0	0	0	nan	0	0	0	nan	nan	nan	nan
18	G	0	0	0	nan	0	0	0	0	0	0	nan	0	0	0	0	0	0	nan	0	0	0	nan	nan	nan	nan
19	U	0	0	0	nan	0	0	0	0	0	0	nan	0	0	0	0	0	0	nan	0	0	0	nan	nan	nan	nan
20	U	0	0	0	nan	0	0	0	0	0	0	nan	0	0	0	0	0	0	nan	0	0	0	nan	nan	nan	nan
21	A	0	0	0	nan	0	0	0	0	0	0	nan	0	0	0	0	0	0	nan	0	0	0	nan	nan	nan	nan
22	G	0	0	0	nan	0	0	0	0	0	0	nan	0	0	0	0	0	0	nan	0	0	0	nan	nan	nan	nan
23	A	0	0	0	nan	0	0	0	0	0	0	nan	0	0	0	0	0	0	nan	0	0	0	nan	nan	nan	nan
24	G	0	0	0	nan	0	0	0	0	0	0	nan	0	0	0	0	0	0	nan	0	0	0	nan	nan	nan	nan
25	C	0	0	0	nan	0	0	0	0	0	0	nan	0	0	0	0	0	0	nan	0	0	0	nan	nan	nan	nan
26	A	0	0	0	nan	0	0	0	0	0	0	nan	0	0	0	0	0	0	nan	0	0	0	nan	nan	nan	nan
27	G	0	0	0	nan	0	0	0	0	0	0	nan	0	0	0	0	0	0	nan	0	0	0	nan	nan	nan	nan
28	G	0	0	0	nan	0	0	0	0	0	0	nan	0	0	0	0	0	0	nan	0	0	0	nan	nan	nan	nan
29	C	0	0	0	nan	0	0	0	0	0	0	nan	0	0	0	0	0	0	nan	0	0	0	nan	nan	nan	nan
30	G	0	0	0	nan	0	0	0	0	0	0	nan	0	0	0	0	0	0	nan	0	0	0	nan	nan	nan	nan
31	A	0	0	0	nan	0	0	0	0	0	0	nan	0	0	0	0	0	0	nan	0	0	0	nan	nan	nan	nan
32	C	0	0	0	nan	0	0	0	0	0	0	nan	0	0	0	0	0	0	nan	0	0	0	nan	nan	nan	nan
33	U	0	0	0	nan	0	0	0	0	0	0	nan	0	0	0	0	0	0	nan	0	0	0	nan	nan	nan	nan
34	C	0	0	0	nan	0	0	0	0	0	0	nan	0	0	0	0	0	0	nan	0	0	0	nan	nan	nan	nan
35	A	0	0	0	nan	0	0	0	0	0	0	nan	0	0	0	0	0	0	nan	0	0	0	nan	nan	nan	nan
36	U	0	0	0	nan	0	0	0	0	0	0	nan	0	0	0	0	0	0	nan	0	0	0	nan	nan	nan	nan
37	A	0	0	0	nan	0	0	0	0	0	0	nan	0	0	0	0	0	0	nan	0	0	0	nan	nan	nan	nan
38	A	0	0	0	nan	0	0	0	0	0	0	nan	0	0	0	0	0	0	nan	0	0	0	nan	nan	nan	nan
39	U	0	0	0	nan	0	0	0	0	0	0	nan	0	0	0	0	0	0	nan	0	0	0	nan	nan	nan	nan
40	C	0	0	0	nan	0	0	0	0	0	0	nan	0	0	0	0	0	0	nan	0	0	0	nan	nan	nan	nan
41	G	0	0	0	nan	0	0	0	0	0	0	nan	0	0	0	0	0	0	nan	0	0	0	nan	nan	nan	nan
42	C	0	0	0	nan	0	0	0	0	0	0	nan	0	0	0	0	0	0	nan	0	0	0	nan	nan	nan	nan
43	U	0	0	0	nan	0	0	0	0	0	0	nan	0	0	0	0	0	0	nan	0	0	0	nan	nan	nan	nan
44	U	0	0	0	nan	0	0	0	0	0	0	nan	0	0	0	0	0	0	nan	0	0	0	nan	nan	nan	nan
45	G	0	0	0	nan	0	0	0	0	0	0	nan	0	0	0	0	0	0	nan	0	0	0	nan	nan	nan	nan
46	G	0	0	0	nan	0	0	0	0	0	0	nan	0	0	0	0	0	0	nan	0	0	0	nan	nan	nan	nan
47	U	0	0	0	nan	0	0	0	0	0	0	nan	0	0	0	0	0	0	nan	0	0	0	nan	nan	nan	nan
48	C	0	0	0	nan	0	0	0	0	0	0	nan	0	0	0	0	0	0	nan	0	0	0	nan	nan	nan	nan
49	G	0	0	0	nan	0	0	0	0	0	0	nan	0	0	0	0	0	0	nan	0	0	0	nan	nan	nan	nan
50	C	0	0	0	nan	0	0	0	0	0	0	nan	0	0	0	0	0	0	nan	0	0	0	nan	nan	nan	nan
51	U	0	0	0	nan	0	0	0	0	0	0	nan	0	0	0	0	0	0	nan	0	0	0	nan	nan	nan	nan
52	G	0	0	0	nan	0	0	0	0	0	0	nan	0	0	0	0	0	0	nan	0	0	0	nan	nan	nan	nan
53	G	0	0	0	nan	0	0	0	0	0	0	nan	0	0	0	0	0	0	nan	0	0	0	nan	nan	nan	nan
54	U	0	0	0	nan	0	0	0	0	0	0	nan	0	0	0	0	0	0	nan	0	0	0	nan	nan	nan	nan
55	U	0	0	0	nan	0	0	0	0	0	0	nan	0	0	0	0	0	0	nan	0	0	0	nan	nan	nan	nan
56	C	0	0	0	nan	0	0	0	0	0	0	nan	0	0	0	0	0	0	nan	0	0	0	nan	nan	nan	nan
57	A	0	0	0	nan	0	0	0	0	0	0	nan	0	0	0	0	0	0	nan	0	0	0	nan	nan	nan	nan
58	A	0	0	0	nan	0	0	0	0	0	0	nan	0	0	0	0	0	0	nan	0	0	0	nan	nan	nan	nan
59	G	0	0	0	nan	0	0	0	0	0	0	nan	0	0	0	0	0	0	nan	0	0	0	nan	nan	nan	nan
60	U	0	0	0	nan	0	0	0	0	0	0	nan	0	0	0	0	0	0	nan	0	0	0	nan	nan	nan	nan
61	C	0	0	0	nan	0	0	0	0	0	0	nan	0	0	0	0	0	0	nan	0	0	0	nan	nan	nan	nan
62	C	0	0	0	nan	0	0	0	0	0	0	nan	0	0	0	0	0	0	nan	0	0	0	nan	nan	nan	nan
63	A	0	0	0	nan	0	0	0	0	0	0	nan	0	0	0	0	0	0	nan	0	0	0	nan	nan	nan	nan
64	G	0	0	0	nan	0	0	0	0	0	0	nan	0	0	0	0	0	0	nan	0	0	0	nan	nan	nan	nan
65	C	0	0	0	nan	0	0	0	0	0	0	nan	0	0	0	0	0	0	nan	0	0	0	nan	nan	nan	nan
66	A	0	0	0	nan	0	0	0	0	0	0	nan	0	0	0	0	0	0	nan	0	0	0	nan	nan	nan	nan
67	A	0	0	0	nan	0	0	0	0	0	0	nan	0	0	0	0	0	0	nan	0	0	0	nan	nan	nan	nan
68	G	0	0	0	nan	0	0	0	0	0	0	nan	0	0	0	0	0	0	nan	0	0	0	nan	nan	nan	nan
69	G	0	0	0	nan	0	0	0	0	0	0	nan	0	0	0	0	0	0	nan	0	0	0	nan	nan	nan	nan
70	G	0	0	0	nan	0	0	0	0	0	0	nan	0	0	0	0	0	0	nan	0	0	0	nan	nan	nan	nan
71	C	0	0	0	nan	0	0	0	0	0	0	nan	0	0	0	0	0	0	nan	0	0	0	nan	nan	nan	nan
72	C	0	0	0	nan	0	0	0	0	0	0	nan	0	0	0	0	0	0	nan	0	0	0	nan	nan	nan	nan
73	A	0	0	0	nan	0	0	0	0	0	0	nan	0	0	0	0	0	0	nan	0	0	0	nan	nan	nan	nan
74	C	0	0	0	nan	0	0	0	0	0	0	nan	0	0	0	0	0	0	nan	0	0	0	nan	nan	nan	nan
75	C	0	0	0	nan	0	0	0	0	0	0	nan	0	0	0	0	0	0	nan	0	0	0	nan	nan	nan	nan
76	A	0	0	0	nan	0	0	0	0	0	0	nan	0	0	0	0	0	0	nan	0	0	0	nan	nan	nan	nan